honor: If you need it defined, you don't have it.
america: The only country that matters. If you want to experience other "cultures", use an atlas or a ham radio.
buffets: Whenever available, choose quantity over quality.
teamwork: Work together as if your life depended on it... IT DOES!
selfishness: Take what's yours
haircuts: 3 acceptable styles - high and tight, crew cut and buzz cut
greatness itself: The best revenge
discipline: The ability to repeat a boring thing over and over again
attire: Shorts over 6" are capri pants. Shorts under 6" are european
self-reliance: Trust yourself
suspicion: Do not trust anyone else
skim milk: That's right. It's on here twice. Avoid it.
intensity: Give 100%. 110% is impossible. Only idiots recommend that
torso: Should be thick and impenetrable
old wooden sailing ships: They're beautiful
b.o.: Cultivating a manly musk puts your opponents on notice
stillness: Don't waste energy moving unless necessary
cursing: There's only one bad word:  Taxes. If any other word is good enough for sailors, it's good enough for you
friends: one to three is sufficient.
property rights: They exist. Do not let them be taken away from you.
masonry: Building walls makes you strong. Defending them makes you even stronger.
cabins: A place do rent that is made of logs
perspiration: Only sweat during physical activity or love making. No emotional sweating.
you: You are your biggest ally
crying: Acceptable at funerals and the Grand Canyon
frankness: Cut the B.S.
capitalism: God's way to determining who is smart, and who is poor
facial hair: Full, thick and square. Nothing sculpted. If you have to sculpt it, that probably means that you can't grow it.
living in the woods: Living off the land.
rage: One rage every three months is permitted. Try not to hurt anyone who doesn't deserve it.
security: Secure the land.
poise: Sting like a bee. Do not float like a butterfly. That is ridiculous.
handshakes: Firm. Dry. Solid. 3 seconds.
body grooming: Only women shave beneath the neck.
weapons: I approve
wood working: I approve
welfare avoidance: I approve
cow protein: good for you
pig protein: good for you
chicken protein: good for you
romantic love: good for you
deer protein: good for you
fish: sport only
